1111111
1P1C0C1
1010101
1C0C1E1
1111111