11111111111111111111111111111111111
1P000C00000000000000000000000000001
11111111111111111111111111111111101
10000C00000000000000000000000000001
10111111111111111111111111111111111
10000C00000000000000C000000000C0001
11111111111111111111111111111111101
10000C00000000C00000000000000000001
10111111111111111111111111111111111
10000C000000000000000000000000000E1
11111111111111111111111111111111111