11111111111
11111C11111
11110E01111
11100000111
11000000011
1C000P000C1
10000000001
11000000011
11001110011
10011111001
1C1111111C1
11111111111