11111111111111111111111
100000000000000000000E1
1C1111111111111111111C1
10011111111111111111C01
1CCC111111111111111C0C1
100001111111111111C0C01
1CCCCC11111111111C0C0C1
1CCCCCC111111111C0C0C01
1CCCCCCC1111111C0C0C0C1
101C1C11111111C0C0C0C01
1CCCCCCCCCP11C0C0C0C0C1
11111111111111111111111