11111111111111111111111
100000000000000000000E1
1C1111111111111111111C1
10011111111111111111CC1
1CCC111111111111111CCC1
100001111111111111CCCC1
1CCCCC11111111111CCCCC1
1CCCCCC111111111CCCCCC1
1CCCCCCC1111111CCCCCCC1
101C1C11111111CCCCCCCC1
1CCCCCCCCCP11CCCCCCCCC1
11111111111111111111111