111111111111111111111111111
100011101CC1111111101111111
1010000000000000000000000E1
101111111111011111111111111
101111111111011111111111111
100000000000011111111111111
101111111111111111111111111
1000000000000P1111111111111
111111111111111111111111111