111111111111111111111111111111111111111
1E0000000000000000000000000000000000001
1000000000000000CCCCCCCC000000000000001
10000000000000CCCCCCCCCCCC0000000000001
100000000000CCCCCCCCCCCCCCCC00000000001
100000000000CCCC1CCCCCC1CCCC00000000001
100000000000CCCC1CCCCCC1CCCC00000000001
100000000000CCCCCC1111CCCCCC00000000001
100000000000CCCCCCC11CCCCCCC00000000001
1000000000000CCCCCCCCCCCCCC000000000001
10000000000000CCCCCCCCCCCC0000000000001
100000000000001111111111110000000000001
100000000000001000000000010000000000001
100000000000001111111111110000000000001
1000000CC000000000000000000000CC0000001
1000000CCCC00000000000000000CCCC0000001
10000000CCCCCC00000000000CCCCCC00000001
100000000CCCCCCCCCCCCCCCCCCCCC000000001
100000000CCCCCCCCCCCCCCCCCCCCC000000001
10000000CCCCCC00000000000CCCCCC00000001
1000000CCCC00000000000000000CCCC0000001
1000000CC000000000000000000000CC0000001
1P0000000000000000000000000000000000001
111111111111111111111111111111111111111