11111111111
1C001C100C1
10001010001
1C100P001C1
10111111101
1C1111111C1
10000E00001
11111111111