1111111
1PXC0C1
10X0X01
1C0CXE1
1111111