111111111111
1000000000P1
10XXXXXXXX01
10X00X000X01
10X0000X0001
10X0XXXXXXX1
1000CCCCCCC1
10XXXXXXXXX1
100000000001
1XXXXXXXCXC1
1XXXXXXX0XX1
1XXCCC000XC1
1CC000CCCC01
10000X0000E1
111111111111